FILE_TYPE=VERILOG_MAP;
PRIMITIVE '10E016';
    DEFAULT_MODEL=MC10E016;
    UPPER_CASE=TRUE;
    MODEL 'MC10E016';
        PIN_MAP
            'Q'<7>='(Q7)';
            'Q'<6>='(Q6)';
            'Q'<5>='(Q5)';
            'Q'<4>='(Q4)';
            'Q'<3>='(Q3)';
            'Q'<2>='(Q2)';
            'Q'<1>='(Q1)';
            'Q'<0>='(Q0)';
            'P'<7>='(P7)';
            'P'<6>='(P6)';
            'P'<5>='(P5)';
            'P'<4>='(P4)';
            'P'<3>='(P3)';
            'P'<2>='(P2)';
            'P'<1>='(P1)';
            'P'<0>='(P0)';
            'MR'='(MR)';
            'CLK'='(CLK)';
            '-TC'='(TC_)';
            'TCLD'='(TCLD)';
            '-PE'='(PE_)';
            '-CE'='(CE_)';
        END_PIN;
    END_MODEL;
END_PRIMITIVE;
END.
