FILE_TYPE=VERILOG_MAP;
PRIMITIVE 'IDS_C34'; 
    DEFAULT_MODEL=IDS_C34;
    UPPER_CASE=TRUE;
    MODEL 'IDS_C34';
        PIN_MAP
            'PIN1'='(PIN1)';
            'PIN2'='(PIN2)';
            'PIN3'='(PIN3)';
            'PIN4'='(PIN4)';
            'PIN5'='(PIN5)';
            'PIN6'='(PIN6)';
            'PIN7'='(PIN7)';
            'PIN8'='(PIN8)';
            'PIN9'='(PIN9)';
            'PIN10'='(PIN10)';
            'PIN11'='(PIN11)';
            'PIN12'='(PIN12)';
            'PIN13'='(PIN13)';
            'PIN14'='(PIN14)';
            'PIN15'='(PIN15)';
            'PIN16'='(PIN16)';
            'PIN17'='(PIN17)';
            'PIN18'='(PIN18)';
            'PIN19'='(PIN19)';
            'PIN20'='(PIN20)';
            'PIN21'='(PIN21)';
            'PIN22'='(PIN22)';
            'PIN23'='(PIN23)';
            'PIN24'='(PIN24)';
            'PIN25'='(PIN25)';
            'PIN26'='(PIN26)';
            'PIN27'='(PIN27)';
            'PIN28'='(PIN28)';
            'PIN29'='(PIN29)';
            'PIN30'='(PIN30)';
            'PIN31'='(PIN31)';
            'PIN32'='(PIN32)';
            'PIN33'='(PIN33)';
            'PIN34'='(PIN34)';
        END_PIN;
    END_MODEL;
END_PRIMITIVE;
END.
