FILE_TYPE=VERILOG_MAP;
PRIMITIVE 'DIPSWITCH';
    DEFAULT_MODEL=SNODIPSWITCH;
    UPPER_CASE=TRUE;
    MODEL 'DIPSWITCH';
        PIN_MAP
            'B0'='(B0)';
            'B1'='(B1)';
            'B2'='(B2)';
            'B3'='(B3)';
            'B4'='(B4)';
            'B5'='(B5)';
            'B6'='(B6)';
            'B7'='(B7)';
            'A0'='(A0)';
            'A1'='(A1)';
            'A2'='(A2)';
            'A3'='(A3)';
            'A4'='(A4)';
            'A5'='(A5)';
            'A6'='(A6)';
            'A7'='(A7)';
        END_PIN;
    END_MODEL;
END_PRIMITIVE;
END.
